NO assets/Darksouls3.xpm
SO assets/shadowofthecolossus.xpm
WE assets/thelastofus.xpm
EA assets/Zelda.xpm

F 13,128,99
C 50,50,50

        1111111111111111111111111111111111111111111111
        10000000000011000000000000000000000000000000S1
        1011000001110000001000001111111111111111111111
        1001000000000000000000001
111111111011000001110000001000001
100000000011000001110111100011111
11110001001111011100000010001
11110111111101011101010010001
11000000010101011100000010001
10000000000001000000000010001
10000000000000001100000010001
10000000000010001101010010001
1100000111010001111101111000110
11110111 1000101 101111010001
11111111 1111111 111111111111